. . . . . . c . . . . . . . c . . . . . . . . . . . . . . . . . . . . . . . . . . . . . . . . . . . . . . . . . . . . . . . . . . . . . . c c c c . . c c p p p p c c . . . . . . . . c . . . . . . . .
. . . . . . c c . . . . . c c . . . . . . . . . . . . . . . . . . . . . . . . . . . . . . . . . . . . . . . c c c . . . . . c c c . . . . 1 2 4 5 . . 1 3 5 . . 1 3 5 c . . . . . . c . c . . c . . . .
. . c c c c c a c . . . c a c c c c c . . . . . c p c . . . . . . . . . . . . . . . . . . . . c c . . . . c c c c c . . . c c c c c . . . . . . . . . . . . . . . . . . c . . . . . . c . . c . . . . .
. . c c c c c c c c . c c c c c c c c . . . . c 1 3 5 c . . . . . . . . . . . . . . . . . . c . a c . . . c c r c c . . . c c m c c 1 3 5 g . . . . . . . . . . . . . . c . . . . c c p c c . . . . . .
. . t c c c c c c . . . c c c c c c t . c c c . . . . . c c c . . . . c c . . c c . . . . c . p . c . . . . c c c . . . . . c c c . . . . . c c c . . . . . . . . . c c . . . . c . . c . . . . . . . .
. . . . . . c c . . . . . c c . . . . c 1 3 5 . . . . . 1 3 5 c . . c 1 5 c c 1 5 c . . c . a . . . c c . 1 2 3 4 5 . . . 1 2 3 4 5 . . . 1 2 4 5 c . . . . . c c c 1 3 5 . . c . . c . c . . . . . . .
m . . . . . c . . . . . . . c . . . . . . . . . . . . . . . . b c c . . . b . . . . c c c p c c c c c c . . . . . . . c . . . . . . . . . . . . . . c c t c c . . . . . . . . . . c . . . c . . . . . .