. . . . . . . . . . . . . a . . . . . . . . . . . . . . c c c c a c c c c . . . . . . . . . . . . . . . . . t . . . . c c c c c c c c c c c c c c . . . . . . . . . . . b . . . . . . . . . . . . . .
. . . . . . . . . . 1 2 3 4 4 5 . . . . . . . . . . . c 1 2 2 3 4 4 5 . c . . . . . . . . . . . . . . . . . 1 2 3 4 5 c c c c c c c c c c c c c c . . . . . . . . . . . 1 2 2 3 3 4 4 5 . . . . . . .
. . . . . . . . . . b . . . . . . . . . . . c c c c c t . . . . . . . . . c . . . . . . . . . . g . . . . . . . . . . c c c c c c c c c c c c c c . . . . . . . . . . . m c c c c c c c c . . . . . .
. . . . . . 1 2 3 4 5 . . . . . . . . . . c 1 2 3 4 5 . . . . . . . . . . . c . . . . . . . . . 1 2 3 4 2 3 4 5 . . . c c c c c c a p a c c c c c . . . . . . 1 3 4 5 . 1 2 2 3 3 4 4 5 . c . . . . .
. . . . . . t . . . . . . . . . . c c c c t . . . . a . . . . . a . . . . . . c . . c c c c c c c . . . . . . . . . . c c c c c c c c c c c c c c . . . . . . . . . . . b . . . . . . . . . c . . . .
. . 1 2 3 4 5 . . . . . . . . . c 1 2 4 5 . . . . c c c . . . c c c . . . . . . c c 1 2 3 3 4 4 5 c . . . . . . . . c 1 1 2 2 3 3 4 4 2 3 4 1 5 5 c . . 1 2 5 . . . . . 1 2 2 3 3 4 4 5 . . . c . . .
. . g . . . . . . . . c c c c c t . . . . . . . c c c c c r c c c c c . . . . . . . . . . . . . . . c c c c c c c . . . . . . . . . . . . . . . . c . . . . . . . . . . . . . . . . . . . . . . c . .