. . . . . . . . . . . . . . . . . . . . . . . . . . . . . . . . . . . . . . . . . . . . . . . . . . . . . . . . . . . . . . . c c c c c c c c c . . . . . . . . . . . . . . . . . . . . . . . . . . . .
. . . . . . . . . . . . . . . . . . . . . . . c c c c c . . . . . . . c . . . c . . . . . . . . . . . . . m . . . . . . . . c c c c c c c c c c c . . . . . . . c . . . . . . . . . c c . . . . . . . .
. . . . . . . . . . . . . . . . . . . . . . 1 2 2 3 4 4 5 . . . . . c . c . c . c . . . . . . . . . . 1 2 3 5 . . . . . . c c c c c c c c 1 3 5 c c . . . . . 1 4 5 . . . . . . . 1 2 4 5 . . . . . . .
. . . . . . . . . . . . . . . . c c . . . . . . . . . . . . . . . c . . . c . . . c . . . . c c c c c . . . . . . . . . . c c c c c c p c c c c c c . . . c . . . . c . c r c . c . . . . . . . . . . .
. . . . . . . . . . . . . . . 1 3 3 5 . . . . . . . . . . . . . . . c . . . . . c . . . . . 1 2 3 4 5 . . . . 1 2 3 4 5 . c c c c c 1 2 5 c c c c c . . 1 2 5 . . . 1 2 2 3 4 4 5 . . . . . . . . . . .
. . . . . . . . . c c c . . . . . . . . . . . . . . . . . . . . . . . c . a . c . . . b . . . . . . . . . . . . . . . . . . c c c c c c c c c c c . . . . . . . . . . . . . . . . . . . . . . . . . . .
. . . . . . . . 1 2 3 4 5 . . . . . . . . . . . . . . . . . . . . . . . c . c . . 1 2 3 4 5 . . . . . . . . . . . . . . . . 1 2 4 5 c c c c c c . 1 3 5 . . . . . . . . . . . . . . . . . . . . . . . .
. . . . . . . . . . . . . . . . . . . . . . . . . . . . . . . . . . . . . . . . . g . . . . . . . . . . . . . . . . . . . . . t . . . . . . . . . . . . . . . . . . . . . . . . . . . . . . . . . . . .