. . . . . . . . . . . . . . . . . . . . . . . . . . . . . . . . . . . . . . . . . . . . . . . . . . . . . . c c c c . . . c c c c c a c c c c c c c c c c c . . . . . . . . . a . . . . . . . . . . . 
. . . . . . . . . . a a . . . . . a a . . . . . . . . . . . . . . . . . . . . . . . . . . . . . . . . . . . 1 2 4 5 . . . 1 2 2 3 3 4 4 5 c c c c c c c c c . . . . . c c c c c c c c c . . . . . . .
. . . . . . . . . c . . c . . . c . . c . . . . . . . . . . . . . . . . . . . . . . c c c c . . c c c c c c g . . . . . . b . . . . . . . c c c c c c c c c . . . . . . c c c c c c c . . . . . . . .
. . . . . . . . . 1 2 4 5 . . . 1 2 4 5 . . . . . . . . . . . . . . . . . . . . . 1 2 4 5 . . . 1 2 2 2 2 2 3 3 3 3 3 4 4 4 4 5 . . . . . c c c c c c c c c . . . . . . . t t t t t . . . . . . . . .
. . . . c c c . . . . . c c m c c . . . c c c p c c c c . . . c c p c c . . c c c c g . . . . . g . . . . . . . . . . . . . . . . . . . . c c c c g c c c c . . . . . . c c c c c c c . . . . . . . .
. . . . 1 3 5 . . . . . 1 2 3 4 5 . . . 1 2 2 3 3 4 4 5 . . . 1 2 3 4 5 . . 1 2 2 2 2 2 3 3 3 3 3 4 4 4 4 5 . . . . . . . . . . . . . . . c t c c c c c c c . . . . . c c c c c c c c c . . . . . . .
r . . . . . . . . . . . . . . . . . . . b . . . . . . . . . . b . . . . . . b . . . . . . . . . . . . . . . . . . . . . . . . . . . . . . c c c c c c c c a . . . . . . . . . a . . . . . . . . . . .
