. . . . . . c c . . . . . . c c c . . . c c . . c . . c . c c c c . c c c . . . c . . . . . . . . . . p . . c . . . . . c . . . . . . . . . . . . . . . . . . . . . . . . . . . . . c c . . . . . . . .
. . . . . . 1 5 . . . . . . c . . c . c . . c . c . . c . c . . . . c . . c . . c . . . . . . . . . . 1 3 5 . c . . . c . . . . . . . . . . . . . . . . . . . . . . . . . . . . . c 1 5 c . . . . . . .
. . . . c c . . c c . . . . c . . c . c . . c . c . c . . c . . . . c . . c . . c c c c . . . . p . . . . . . . c . c . . . . c c c c . c c c . . . . . . . . . . . . . . . . . c . . t . c . . . . . .
. . . c 1 5 . . 1 5 . . . . c a c . . c a c c . c a . . . a c c c . c a c . . . c c c c . . . . 1 3 5 . . . . . . c . . . . . 1 2 4 5 . 1 3 5 c . . . . . . . . . . . . . . . c 1 5 . t . . c . . . . .
. . r c . . . . . . c c . . c . . c . c . . c . c . c . . c . . . . c . . c . . c a a c . p . . . . . . . . . . c . c . . . . p . . . . . . . . c . . . c c c c c c . . . . c . . . . t . . . c . . . .
. . 1 5 . . . . . . 1 5 . . c . . c . c . . c . c . . c . c . . . . c . . c . . c c c c . 1 3 5 . . . . . . . c . . . c . . 1 3 5 . 1 2 4 5 . . . c . c 1 2 3 4 4 5 c . . c . 1 5 . . t . . . . c . . .
. . b . g . . . g . b . . m c c c . . c . . c . c . . c . c c c c . c . . c . . c c c c . . . . . . . . . . c . . . . . m . . . . . . . . . . . . . c . . . . . . . . c r . . . . . . t . . . . . c . .